111111111111
1P0000C1EC01
10011111C011
10000C000111
111111111111
